Analiza Umiejtnoci (Tab 1)
Wykres supkowy najpopularniejszych umiejtnoci - Top 20 najczciej wymaganych umiejtnoci
Metryki statystyk umiejtnoci - Liczba ofert dla top 10 umiejtnoci z procentami
Tabela najczstszych kombinacji umiejtnoci - Top 15 kombinacji umiejtnoci
Wykres supkowy wagi umiejtnoci - Umiejtnoci wa偶one wedug poziomu zaawansowania
Wykres supkowy umiejtnoci wedug poziom贸w - Rozkad poziom贸w (Junior/Regular/Senior/Expert) dla umiejtnoci
Macierz wa偶noci umiejtnoci (scatter plot) - Czstotliwo vs wa偶no umiejtnoci
Tabela rankingu umiejtnoci - Top 20 umiejtnoci wedug wagi wa偶noci
 Poziomy Dowiadczenia (Tab 2)
Wykres supkowy rozkadu poziom贸w dowiadczenia - Liczba ofert dla ka偶dego poziomu seniority
Heatmapa umiejtnoci vs dowiadczenie - Zale偶no midzy poziomem dowiadczenia a wymaganymi umiejtnociami
 Analiza Lokalizacji (Tab 3)
Wykres supkowy rozkadu ofert w miastach - Top 15 miast wedug liczby ofert
Tabela najwa偶niejszych umiejtnoci w miastach - Umiejtnoci wedug lokalizacji
 Analiza Firm (Tab 4)
Wykres supkowy top firm zatrudniajcych - Top 15 firm z najwiksz liczb ofert
Wykres koowy typ贸w pracy - Podzia Remote vs Stacjonarna/Hybrydowa
 Trendy Rynkowe (Tab 5)
Wykres liniowy trend贸w publikacji ofert - Liczba ofert w czasie
Wykres liniowy trend贸w umiejtnoci - Top 5 umiejtnoci w czasie
Podsumowanie rynku - Tekstowe statystyki
 Analiza Dochod贸w (Tab 6)
Metryki wynagrodze - rednia, mediana, zakres wynagrodze
Wykres supkowy korelacji umiejtnoci z wynagrodzeniami - Wsp贸czynniki korelacji
Heatmapa macierzy korelacji - Korelacje midzy czynnikami a wynagrodzeniem
Wykres regresji liniowej: dowiadczenie vs wynagrodzenie - Scatter plot z lini trendu
Wykres regresji liniowej: liczba umiejtnoci vs wynagrodzenie - Scatter plot z lini trendu
Wykres supkowy najlepiej paccych umiejtnoci - Top 15 umiejtnoci wedug redniej pensji
Wykres supkowy wynagrodze wedug dowiadczenia - rednie pensje dla poziom贸w seniority
Wykres supkowy wynagrodze wedug poziomu biegoci - Pensje wedug poziom贸w umiejtnoci
Histogram rozkadu wynagrodze - Rozkad wszystkich wynagrodze
Wykres zakres贸w wynagrodze - Min-max zakresy dla top 10 umiejtnoci
Tabela szczeg贸owych statystyk wynagrodze - Top 20 umiejtnoci ze statystykami pensji
 Szczeg贸owa Analiza Umiejtnoci (Tab 7)
Metryki przegldu umiejtnoci - Podstawowe statystyki dla wybranej umiejtnoci
Wykres koowy rozkadu poziom贸w umiejtnoci - Poziomy dla konkretnej umiejtnoci
Wykres supkowy analizy seniority - Czstotliwo umiejtnoci wedug seniority
Tabela statystyk wynagrodze - Szczeg贸owe statystyki pensji dla umiejtnoci
Wykres supkowy wynagrodze wedug poziomu - Pensje wedug poziom贸w dla konkretnej umiejtnoci
Wykres liniowy trend贸w rynkowych - Trendy konkretnej umiejtnoci w czasie
Listy top firm i miast - Tekstowe listy dla konkretnej umiejtnoci
Kompleksowy wykres przegldu - Subplot z 4 wykresami (poziomy, seniority, firmy, miasta)
 Dodatkowe Elementy Analityczne
Tabele z danymi - R贸偶ne tabele prezentujce surowe dane i statystyki
Metryki - Liczne metryki wywietlane w kolumnach
Ekspandery z wyjanieniami - Pomoce interpretacyjne dla ka偶dego wykresu